CAN,SNo,Date,Trans Num,Trans Type,Mode,From ,UpTo,Status,Rdg.Date,Rdg.KL,KL,Mths,Debit,Credit,Balance
1,1, 01/05/2009,,WaterRevenueOpeningBalance,,,,,,,,,1.55,,1.55
1,2, 10/06/2009,8835206437,WaterBillCollection,CHQ,,,,,,,,,"748,811.00",-748809.45
1,3, 29/06/2009,8836703552,WaterBillCollection,CHQ,,,,,,,,,"1,037,083.00",-1785892.45
1,4, 23/07/2009,8838488115,WaterBillCollection,CHQ,,,,,,,,,"693,103.00",-2478995.45
1,5, 09/09/2009,8840909723,WaterBillCollection,CHQ,,,,,,,,,"699,703.00",-3178698.45
1,6, 25/09/2009,8842366086,WaterBillCollection,CHQ,,,,,,,,,"767,286.00",-3945984.45
1,7, 16/10/2009,8843672795,WaterBillCollection,CHQ,,,,,,,,,"610,605.00",-4556589.45
1,8, 23/10/2009,3001987,WaterBillDemand,,09-Apr,09-Sep,M,03-10-09,617133,96418,6,4555990.5,,-598.95
1,9, 23/10/2009,,DebitNote,,,,,,,,,598.25,,-0.7
1,10, 05/11/2009,3045333,WaterBillDemand,,09-Oct,09-Oct,M,03-11-09,633646,16513,1,780279.25,,780278.55
1,11, 30/11/2009,8847382672,WaterBillCollection,CHQ,,,,,,,,,"780,279.00",-0.45
1,12, 04/12/2009,3722517,WaterBillDemand,,09-Nov,09-Nov,M,04-12-09,647342,13696,1,647176,,647175.55
1,13, 29/12/2009,124693,WaterBillCollection,CHQ,,,,,,,,,"647,175.00",0.55
1,14, 05/01/2010,4409280,WaterBillDemand,,09-Dec,09-Dec,M,05-01-10,664197,16855,1,796438.75,,796439.3
1,15, 15/01/2010,153700,WaterBillCollection,CHQ,,,,,,,,,"796,439.00",0.3
1,16, 05/02/2010,5084395,WaterBillDemand,,10-Jan,10-Jan,M,04-02-10,680433,16236,1,767191,,767191.3
1,17, 25/02/2010,243340,WaterBillCollection,CHQ,,,,,,,,,"767,191.00",0.3
1,18, 04/03/2010,5745543,WaterBillDemand,,10-Feb,10-Feb,M,04-03-10,693090,12657,1,598083.25,,598083.55
1,19, 30/03/2010,304046,WaterBillCollection,CHQ,,,,,,,,,"598,083.00",0.55
1,20, 06/04/2010,6449612,WaterBillDemand,,10-Mar,10-Mar,M,05-04-10,709409,16319,1,771112.75,,771113.3
1,21, 28/04/2010,355152,WaterBillCollection,CHQ,,,,,,,,,"771,113.00",0.3
1,22, 04/05/2010,7081835,WaterBillDemand,,10-Apr,10-Apr,M,04-05-10,727252,17843,1,843121.75,,843122.05
1,23, 31/05/2010,412316,WaterBillCollection,CHQ,,,,,,,,,"843,122.00",0.05
1,24, 05/06/2010,7798638,WaterBillDemand,,10-May,10-May,M,05-06-10,752127,24875,1,1175383.75,,1175383.8
1,25, 01/07/2010,465720,WaterBillCollection,CHQ,,,,,,,,,"1,175,383.00",0.8
1,26, 05/07/2010,8492394,WaterBillDemand,,10-Jun,10-Jun,M,05-07-10,773711,21584,1,1019884,,1019884.8
1,27, 22/07/2010,503638,WaterBillCollection,CHQ,,,,,,,,,"1,019,884.00",0.8
1,28, 04/08/2010,9164042,WaterBillDemand,,10-Jul,10-Jul,M,04-08-10,791534,17823,1,842156.75,,842157.55
1,29, 31/08/2010,565832,WaterBillCollection,CHQ,,,,,,,,,"842,157.00",0.55
1,30, 06/09/2010,9965280,WaterBillDemand,,10-Aug,10-Aug,M,06-09-10,804679,13145,1,621121.25,,621121.8
1,31, 24/09/2010,606745,WaterBillCollection,CHQ,,,,,,,,,"621,121.00",0.8
1,32, 04/10/2010,10558710,WaterBillDemand,,10-Sep,10-Sep,M,04-10-10,816864,12185,1,575761.25,,575762.05
1,33, 19/10/2010,645361,WaterBillCollection,CHQ,,,,,,,,,"575,762.00",0.05
1,34, 04/11/2010,11320532,WaterBillDemand,,10-Oct,10-Oct,M,04-11-10,834000,17136,1,809696,,809696.05
1,35, 04/12/2010,12042865,WaterBillDemand,,10-Nov,10-Nov,M,04-12-10,852521,18521,1,875137.25,,1684833.3
1,36, 06/12/2010,725256,WaterBillCollection,CHQ,,,,,,,,,"809,696.00",875137.3
1,37, 29/12/2010,769781,WaterBillCollection,CHQ,,,,,,,,,"875,137.00",0.3
1,38, 04/01/2011,12751225,WaterBillDemand,,10-Dec,10-Dec,M,04-01-11,869531,17010,1,803742.5,,803742.8
1,39, 31/01/2011,821508,WaterBillCollection,CHQ,,,,,,,,,"803,742.00",0.8
1,40, 07/02/2011,13597289,WaterBillDemand,,11-Jan,11-Jan,M,07-02-11,884958,15427,1,728945.75,,728946.55
1,41, 28/02/2011,864860,WaterBillCollection,CHQ,,,,,,,,,"728,946.00",0.55
1,42, 08/03/2011,14361980,WaterBillDemand,,11-Feb,11-Feb,M,07-03-11,900044,15086,1,712833.5,,712834.05
1,43, 31/03/2011,914631,WaterBillCollection,CHQ,,,,,,,,,"712,834.00",0.05
1,44, 06/04/2011,15002580,WaterBillDemand,,11-Mar,11-Mar,M,05-04-11,916279,16235,1,767123.75,,767123.8
1,45, 30/04/2011,962897,WaterBillCollection,CHQ,,,,,,,,,"767,123.00",0.8
1,46, 05/05/2011,15727306,WaterBillDemand,,11-Apr,11-Apr,M,05-05-11,933637,17358,1,820185.5,,820186.3
1,47, 20/05/2011,994754,WaterBillCollection,CHQ,,,,,,,,,"820,186.00",0.3
1,48, 06/06/2011,16497082,WaterBillDemand,,11-May,11-May,M,06-06-11,954339,20702,1,978189.5,,978189.8
1,49, 25/06/2011,1054970,WaterBillCollection,CHQ,,,,,,,,,"978,189.00",0.8
1,50, 07/07/2011,17267342,WaterBillDemand,,11-Jun,11-Jun,M,06-07-11,975590,21251,1,1004129.75,,1004130.55
1,51, 27/07/2011,1109399,WaterBillCollection,CHQ,,,,,,,,,"1,004,130.00",0.55
1,52, 05/08/2011,17959099,WaterBillDemand,,11-Jul,11-Jul,M,05-08-11,992205,16615,1,785078.75,,785079.3
1,53, 27/08/2011,1157731,WaterBillCollection,CHQ,,,,,,,,,"785,079.00",0.3
1,54, 06/09/2011,18717465,WaterBillDemand,,11-Aug,11-Aug,M,06-09-11,1008341,16136,1,762446,,762446.3
1,55, 24/09/2011,1196559,WaterBillCollection,CHQ,,,,,,,,,"762,446.00",0.3
1,56, 07/10/2011,19478491,WaterBillDemand,,11-Sep,11-Sep,M,07-10-11,1022244,13903,1,656936.75,,656937.05
1,57, 29/10/2011,1233311,WaterBillCollection,CHQ,,,,,,,,,"656,937.00",0.05
1,58, 09/11/2011,20354127,WaterBillDemand,,11-Oct,11-Oct,M,08-11-11,1039541,17297,1,817303.25,,817303.3
1,59, 05/12/2011,21428271,WaterBillDemand,,11-Nov,11-Nov,M,05-12-11,1051582,12041,1,568957.25,,1386260.55
1,60, 09/12/2011,1294949,WaterBillCollection,CHQ,,,,,,,,,"817,303.00",568957.55
1,61, 29/12/2011,1330933,WaterBillCollection,CHQ,,,,,,,,,"568,957.00",0.55
1,62, 07/01/2012,22209418,WaterBillDemand,,11-Dec,11-Dec,M,07-01-12,1066786,15204,1,1026290,,1026290.55
1,63, 02/02/2012,1385188,WaterBillCollection,DD,,,,,,,,,"1,026,291.00",-0.45
1,64, 06/02/2012,22965876,WaterBillDemand,,12-Jan,12-Jan,M,06-02-12,1083107,16321,1,1101687.5,,1101687.05
1,65, 29/02/2012,1432253,WaterBillCollection,CHQ,,,,,,,,,"1,101,687.00",0.05
1,66, 09/03/2012,23804523,WaterBillDemand,,12-Feb,12-Feb,M,09-03-12,1102107,19000,1,1282520,,1282520.05
1,67, 29/03/2012,1483660,WaterBillCollection,DD,,,,,,,,,"1,282,520.00",0.05
1,68, 07/04/2012,24563541,WaterBillDemand,,12-Mar,12-Mar,M,05-04-12,1122123,20016,1,1351100,,1351100.05
1,69, 28/04/2012,1540348,WaterBillCollection,DD,,,,,,,,,"1,351,100.00",0.05
1,70, 02/05/2012,25297803,WaterBillDemand,,12-Apr,12-Apr,M,02-05-12,1145348,23225,1,1567707.5,,1567707.55
1,71, 19/05/2012,1580002,WaterBillCollection,CHQ,,,,,,,,,"1,567,708.00",-0.45
1,72, 04/06/2012,26084481,WaterBillDemand,,12-May,12-May,M,04-06-12,1173090,27742,1,1872605,,1872604.55
1,73, 21/06/2012,1641548,WaterBillCollection,DD,,,,,,,,,"1,872,605.00",-0.45
1,74, 05/07/2012,26876470,WaterBillDemand,,12-Jun,12-Jun,M,05-07-12,1192794,19704,1,1330040,,1330039.55
1,75, 31/07/2012,1714588,WaterBillCollection,DD,,,,,,,,,"1,330,040.00",-0.45
1,76, 07/08/2012,27670357,WaterBillDemand,,12-Jul,12-Jul,M,06-08-12,1212190,19396,1,1309250,,1309249.55
1,77, 22/08/2012,1751876,WaterBillCollection,DD,,,,,,,,,"1,309,250.00",-0.45
1,78, 04/09/2012,28424272,WaterBillDemand,,12-Aug,12-Aug,M,04-09-12,1229535,17345,1,1170807.5,,1170807.05
1,79, 21/09/2012,1806404,WaterBillCollection,DD,,,,,,,,,"1,170,807.00",0.05
1,80, 04/10/2012,29207152,WaterBillDemand,,12-Sep,12-Sep,M,04-10-12,1243104,13569,1,915927.5,,915927.55
1,81, 29/10/2012,1874841,WaterBillCollection,DD,,,,,,,,,"915,928.00",-0.45
1,82, 05/11/2012,29992179,WaterBillDemand,,12-Oct,12-Oct,M,05-11-12,1256725,13621,1,919437.5,,919437.05
1,83, 24/11/2012,1926664,WaterBillCollection,DD,,,,,,,,,"919,437.00",0.05
1,84, 06/12/2012,30782787,WaterBillDemand,,12-Nov,12-Nov,M,05-12-12,1272763,16038,1,1082585,,1082585.05
1,85, 26/12/2012,1990500,WaterBillCollection,DD,,,,,,,,,"1,082,585.00",0.05
1,86, 05/01/2013,31554944,WaterBillDemand,,12-Dec,12-Dec,M,04-01-13,1288815,16052,1,1083530,,1083530.05
1,87, 31/01/2013,SBHYH13031303601,WaterBillCollection,,,,,,,,,,"1,083,530.00",0.05
1,88, 07/02/2013,32329070,WaterBillDemand,,13-Jan,13-Jan,M,05-02-13,1306950,18135,1,1224132.5,,1224132.55
1,89, 23/02/2013,SBHYH13054302569,WaterBillCollection,,,,,,,,,,"1,224,132.00",0.55
1,90, 05/03/2013,33101282,WaterBillDemand,,13-Feb,13-Feb,M,05-03-13,1322882,15932,1,1075430,,1075430.55
1,91, 16/03/2013,SBHYH13075302993,WaterBillCollection,,,,,,,,,,"1,075,430.00",0.55
1,92, 08/04/2013,33911961,WaterBillDemand,,13-Mar,13-Mar,M,06-04-13,1349958,27076,1,1827650,,1827650.55
1,93, 23/04/2013,SBHYH13113302793,WaterBillCollection,,,,,,,,,,"1,827,651.00",-0.45
1,94, 03/05/2013,34662021,WaterBillDemand,,13-Apr,13-Apr,M,03-05-13,1371468,21510,1,1451945,,1451944.55
1,95, 15/05/2013,SBHYH13135301594,WaterBillCollection,,,,,,,,,,"1,451,944.00",0.55
1,96, 04/06/2013,35446880,WaterBillDemand,,13-May,13-May,M,04-06-13,1405029,33561,1,2265387.5,,2265388.05
1,97, 21/06/2013,SBHYH13172302260,WaterBillCollection,,,,,,,,,,"2,265,388.00",0.05
1,98, 10/07/2013,36291940,WaterBillDemand,,13-Jun,13-Jun,M,09-07-13,1431034,26005,1,1755357.5,,1755357.55
1,99, 23/07/2013,SBHYH13204301978,WaterBillCollection,,,,,,,,,,"1,755,358.00",-0.45
1,100, 07/08/2013,37057645,WaterBillDemand,,13-Jul,13-Jul,M,06-08-13,1447487,16453,1,1110597.5,,1110597.05
1,101, 23/08/2013,SBHYH13235300736,WaterBillCollection,,,,,,,,,,"1,110,597.00",0.05
1,102, 05/09/2013,37843649,WaterBillDemand,,13-Aug,13-Aug,M,05-09-13,1463980,16493,1,1113297.5,,1113297.55
1,103, 25/09/2013,SBHYH13268302424,WaterBillCollection,,,,,,,,,,"1,113,298.00",-0.45
1,104, 03/10/2013,38625176,WaterBillDemand,,13-Sep,13-Sep,M,03-10-13,1479755,15775,1,1064832.5,,1064832.05
1,105, 24/10/2013,SBHYH13297301932,WaterBillCollection,,,,,,,,,,"1,064,832.00",0.05
1,106, 06/11/2013,39444035,WaterBillDemand,,13-Oct,13-Oct,M,05-11-13,1499215,19460,1,1313570,,1313570.05
1,107, 30/11/2013,SBHYH13334303485,WaterBillCollection,,,,,,,,,,"1,313,570.00",0.05
1,108, 05/12/2013,40249235,WaterBillDemand,,13-Nov,13-Nov,M,05-12-13,1522273,23058,1,1556435,,1556435.05
1,109, 21/12/2013,SBHYH13355301703,WaterBillCollection,,,,,,,,,,"1,556,435.00",0.05
1,110, 07/01/2014,41049159,WaterBillDemand,,13-Dec,13-Dec,M,06-01-14,1547923,25650,1,1731395,,1731395.05
1,111, 22/01/2014,SBHYH14022301827,WaterBillCollection,,,,,,,,,,"1,731,395.00",0.05
1,112, 04/02/2014,41855683,WaterBillDemand,,14-Jan,14-Jan,M,01-02-14,1573667,25744,1,1737740,,1737740.05
1,113, 25/02/2014,SBHYH14056303061,WaterBillCollection,,,,,,,,,,"1,737,740.00",0.05
1,114, 06/03/2014,42692563,WaterBillDemand,,14-Feb,14-Feb,L,,,25744,1,3475460,,3475460.05
1,115, 25/03/2014,SBHYH14084302721,WaterBillCollection,,,,,,,,,,"3,475,460.00",0.05
1,116, 09/04/2014,43554644,WaterBillDemand,,14-Mar,14-Mar,L,,,25744,1,3475460,,3475460.05
1,117, 07/05/2014,44031276,WaterBillDemand,,14-Apr,14-Apr,L,,,25744,1,3475460,,6950920.05
1,118, 09/05/2014,SBHYH14129303294,WaterBillCollection,,,,,,,,,,"3,475,460.00",3475460.05
1,119, 29/05/2014,SBHYH14149302278,WaterBillCollection,,,,,,,,,,"3,475,460.00",0.05
1,120, 09/06/2014,44909365,WaterBillDemand,,14-May,14-May,L,,,25744,1,3475460,,3475460.05
1,121, 27/06/2014,SBHYH14178303742,WaterBillCollection,,,,,,,,,,"3,475,460.00",0.05
1,122, 07/07/2014,45669387,WaterBillDemand,,14-Jun,14-Jun,L,,,25744,1,3475460,,3475460.05
1,123, 09/08/2014,SBHYR52014080900195499,WaterBillCollection,,,,,,,,,,"3,475,460.00",0.05
1,124, 11/08/2014,46638160,WaterBillDemand,,14-Jul,14-Jul,L,,,25744,1,3475460,,3475460.05
1,125, 30/08/2014,SBHYR52014083000281909,WaterBillCollection,,,,,,,,,,"3,475,460.00",0.05
1,126, 09/09/2014,47397671,WaterBillDemand,,14-Aug,14-Aug,L,,,25744,1,3475460,,3475460.05
1,127, 27/09/2014,SBHYR52014092700410343,WaterBillCollection,,,,,,,,,,"3,475,460.00",0.05
1,128, 10/10/2014,48110737,WaterBillDemand,,14-Sep,14-Sep,L,,,25744,1,3475460,,3475460.05
1,129, 27/10/2014,48110737,ReverseWaterBillDemand,,14-Sep,14-Sep,L,,,25744,1,,"3,475,460.00",0.05
1,130, 27/10/2014,47397671,ReverseWaterBillDemand,,14-Aug,14-Aug,L,,,25744,1,,"3,475,460.00",-3475459.95
1,131, 27/10/2014,46638160,ReverseWaterBillDemand,,14-Jul,14-Jul,L,,,25744,1,,"3,475,460.00",-6950919.95
1,132, 27/10/2014,45669387,ReverseWaterBillDemand,,14-Jun,14-Jun,L,,,25744,1,,"3,475,460.00",-10426379.95
1,133, 27/10/2014,44909365,ReverseWaterBillDemand,,14-May,14-May,L,,,25744,1,,"3,475,460.00",-13901839.95
1,134, 27/10/2014,44031276,ReverseWaterBillDemand,,14-Apr,14-Apr,L,,,25744,1,,"3,475,460.00",-17377299.95
1,135, 27/10/2014,43554644,ReverseWaterBillDemand,,14-Mar,14-Mar,L,,,25744,1,,"3,475,460.00",-20852759.95
1,136, 27/10/2014,42692563,ReverseWaterBillDemand,,14-Feb,14-Feb,L,,,25744,1,,"3,475,460.00",-24328219.95
1,137, 28/10/2014,48633595,WaterBillDemand,,14-Feb,14-Sep,M,05-10-14,249731,249724,8,33712900,,9384680.05
1,138, 04/11/2014,48728965,WaterBillDemand,,14-Oct,14-Oct,M,01-11-14,269281,23884,1,3224360,,12609040.05
1,139, 17/11/2014,SBHYR52014111700628181,WaterBillCollection,,,,,,,,,,"3,475,460.00",9133580.05
1,140, 02/12/2014,49497688,WaterBillDemand,,14-Nov,14-Nov,M,01-12-14,296302,27021,1,3647855,,12781435.05
1,141, 13/12/2014,SBHYR52014121300756695,WaterBillCollection,,,,,,,,,,"3,224,360.00",9557075.05
1,142, 01/01/2015,50325597,WaterBillDemand,,14-Dec,14-Dec,M,01-01-15,326780,30478,1,4114550,,13671625.05
1,143, 08/01/2015,SBHYR52015010800886720,WaterBillCollection,,,,,,,,,,"3,647,855.00",10023770.05
1,144, 20/01/2015,SBHYR52015012000941242,WaterBillCollection,,,,,,,,,,"4,114,550.00",5909220.05
1,145, 02/02/2015,51171272,WaterBillDemand,,15-Jan,15-Jan,M,01-02-15,357392,30612,1,4132640,,10041860.05
1,146, 28/02/2015,SBHYR52015022801145969,WaterBillCollection,,,,,,,,,,"4,132,640.00",5909220.05
1,147, 16/03/2015,52591892,WaterBillDemand,,15-Feb,15-Feb,M,01-03-15,384330,26938,1,3636780,,9546000.05
1,148, 31/03/2015,SBHYR52015033101322418,WaterBillCollection,,,,,,,,,,"3,636,780.00",5909220.05
1,149, 03/04/2015,52872715,WaterBillDemand,,15-Mar,15-Mar,M,01-04-15,414958,30628,1,4134930,,10044150.05
1,150, 18/04/2015,SBHYR52015041801407564,WaterBillCollection,,,,,,,,,,"4,134,930.00",5909220.05
1,151, 02/05/2015,53676147,WaterBillDemand,,15-Apr,15-Apr,M,30-04-15,449047,34089,1,4602165,,10511385.05
1,152, 02/06/2015,54524435,WaterBillDemand,,15-May,15-May,M,31-05-15,471958,22911,1,3093135,,13604520.05
1,153, 02/07/2015,55382764,WaterBillDemand,,15-Jun,15-Jun,M,30-06-15,508849,36890,1,4980300,,18584820.05
1,154, 02/07/2015,,ArrearInterestDemand,,,,,,,,,204067.8,,18788887.85
1,155, 08/07/2015,SBHYR52015070801825503,WaterBillCollection,,,,,,,,,,"3,093,135.00",15695752.85
1,156, 02/08/2015,56257894,WaterBillDemand,,15-Jul,15-Jul,M,31-07-15,539400,30551,1,4124535,,19820287.85
1,157, 02/08/2015,,ArrearInterestDemand,,,,,,,,,232375.28,,20052663.13
1,158, 02/09/2015,57123282,WaterBillDemand,,15-Aug,15-Aug,M,31-08-15,569597,30197,1,4076745,,24129408.13
1,159, 02/09/2015,,ArrearInterestDemand,,,,,,,,,294243.3,,24423651.43
1,160, 03/09/2015,SBHYR52015090302096071,WaterBillCollection,,,,,,,,,,"4,124,535.00",20299116.43
1,161, 02/10/2015,57981086,WaterBillDemand,,15-Sep,15-Sep,M,30-09-15,597484,27887,1,3764895,,24064011.43
1,162, 02/10/2015,,ArrearInterestDemand,,,,,,,,,293526.45,,24357537.88
1,163, 03/10/2015,SBHYR52015100302229424,WaterBillCollection,,,,,,,,,,"4,076,745.00",20280792.88
1,164, 28/10/2015,SBHYR52015102802340524,WaterBillCollection,,,,,,,,,,"3,764,895.00",16515897.88
1,165, 31/10/2015,SBHYR52015103102358983,WaterBillCollection,,,,,,,,,,"4,602,165.00",11913732.88
1,166, 31/10/2015,SBHYR52015103102358982,WaterBillCollection,,,,,,,,,,"4,980,300.00",6933432.88
1,167, 02/11/2015,58836349,WaterBillDemand,,15-Oct,15-Oct,M,31-10-15,628572,31088,1,4197030,,11130462.88
1,168, 02/11/2015,,ArrearInterestDemand,,,,,,,,,88638.3,,11219101.18
1,169, 26/11/2015,SBHYR52015112602479508,WaterBillCollection,,,,,,,,,,"4,197,030.00",7022071.18
1,170, 02/12/2015,59709470,WaterBillDemand,,15-Nov,15-Nov,M,30-11-15,654473,25901,1,3496785,,10518856.18
1,171, 02/12/2015,,ArrearInterestDemand,,,,,,,,,88638.3,,10607494.48
1,172, 19/12/2015,SBHYR52015121902600136,WaterBillCollection,,,,,,,,,,"3,496,785.00",7110709.48
1,173, 02/01/2016,60556231,WaterBillDemand,,15-Dec,15-Dec,M,31-12-15,683493,29020,1,3917850,,11028559.48
1,174, 02/01/2016,,ArrearInterestDemand,,,,,,,,,88638.3,,11117197.78
1,175, 02/02/2016,61414018,WaterBillDemand,,16-Jan,16-Jan,M,31-01-16,712440,28947,1,3907995,,15025192.78
1,176, 02/02/2016,,ArrearInterestDemand,,,,,,,,,147406.05,,15172598.83
1,177, 04/02/2016,SBHYR52016020402836872,WaterBillCollection,,,,,,,,,,"3,917,850.00",11254748.83
1,178, 25/02/2016,SBHYR52016022502950921,WaterBillCollection,,,,,,,,,,"3,907,995.00",7346753.83
1,179, 02/03/2016,62302282,WaterBillDemand,,16-Feb,16-Feb,M,29-02-16,741429,28989,1,3913665,,11260418.83
1,180, 02/03/2016,,ArrearInterestDemand,,,,,,,,,88638.3,,11349057.13
1,181, 02/04/2016,63181839,WaterBillDemand,,16-Mar,16-Mar,M,31-03-16,767604,26175,1,3533775,,14882832.13
1,182, 02/04/2016,,ArrearInterestDemand,,,,,,,,,147343.28,,15030175.41
1,183, 02/04/2016,,LatePaymentFee,,,,,,,,,78273.3,,15108448.71
1,184, 11/04/2016,SBHYR52016041103192813,WaterBillCollection,,,,,,,,,,"3,913,665.00",11194783.71
1,185, 21/04/2016,SBHYR52016042103244031,WaterBillCollection,,,,,,,,,,"3,533,775.00",7661008.71
1,186, 02/05/2016,64055696,WaterBillDemand,,16-Apr,16-Apr,M,30-04-16,796738,29134,1,3933240,,11594248.71
1,187, 02/05/2016,,ArrearInterestDemand,,,,,,,,,89812.4,,11684061.11
1,188, 27/05/2016,SBHYR52016052703441316,WaterBillCollection,,,,,,,,,,"3,933,240.00",7750821.11
1,189, 02/06/2016,64942617,WaterBillDemand,,16-May,16-May,M,31-05-16,822574,25836,1,3488010,,11238831.11
1,190, 02/06/2016,,ArrearInterestDemand,,,,,,,,,89812.4,,11328643.51
1,191, 02/06/2016,,LatePaymentFee,,,,,,,,,78664.8,,11407308.31
1,192, 15/06/2016,SBHYR52016061503540235,WaterBillCollection,,,,,,,,,,"3,488,010.00",7919298.31
1,193, 02/07/2016,65827042,WaterBillDemand,,16-Jun,16-Jun,M,30-06-16,848043,25469,1,3438465,,11357763.31
1,194, 02/07/2016,,ArrearInterestDemand,,,,,,,,,90992.37,,11448755.68
1,195, 26/07/2016,SBHYR52016072603742961,WaterBillCollection,,,,,,,,,,"3,438,465.00",8010290.68
1,196, 02/08/2016,66703771,WaterBillDemand,,16-Jul,16-Jul,M,31-07-16,878163,30120,1,4066350,,12076640.68
1,197, 02/08/2016,,ArrearInterestDemand,,,,,,,,,90992.37,,12167633.05
1,198, 02/08/2016,,LatePaymentFee,,,,,,,,,68769.3,,12236402.35
1,199, 30/08/2016,SBHYR52016083003908147,WaterBillCollection,,,,,,,,,,"4,066,350.00",8170052.35
1,200, 02/09/2016,67589631,WaterBillDemand,,16-Aug,16-Aug,M,31-08-16,917578,37772,1,5099370,,13269422.35
1,201, 02/09/2016,,ArrearInterestDemand,,,,,,,,,92023.91,,13361446.26
1,202, 02/09/2016,,LatePaymentFee,,,,,,,,,81327,,13442773.26
1,203, 04/09/2016,67589631,ReverseWaterBillDemand,,16-Aug,16-Aug,M,31-08-16,917578,37772,1,,"5,099,370.00",8343403.26
1,204, 04/09/2016,,ReverseArrearInterestDemand,,,,,,,,,,"92,023.91",8251379.35
1,205, 04/09/2016,,ReverseLatePaymentFee,,,,,,,,,,"81,327.00",8170052.35
1,206, 05/09/2016,67678855,WaterBillDemand,,16-Aug,16-Aug,M,01-09-16,917577,39414,1,5321040,,13491092.35
1,207, 02/10/2016,68505804,WaterBillDemand,,16-Sep,16-Sep,M,30-09-16,951283,33705,1,4550325,,18041417.35
1,208, 02/10/2016,,ArrearInterestDemand,,,,,,,,,171839.51,,18213256.86
1,209, 04/10/2016,SBHYR52016100404072370,WaterBillCollection,,,,,,,,,,"5,321,040.00",12892216.86
1,210, 20/10/2016,SBHYR52016102004145449,WaterBillCollection,,,,,,,,,,"4,550,325.00",8341891.86
1,211, 02/11/2016,69523241,WaterBillDemand,,16-Oct,16-Oct,M,01-11-16,983835,32552,1,4394670,,12736561.86
1,212, 02/11/2016,,ArrearInterestDemand,,,,,,,,,92023.91,,12828585.77
1,213, 28/11/2016,SBHYR52016112810004510,WaterBillCollection,,,,,,,,,,"4,394,670.00",8433915.77
1,214, 05/12/2016,70575106,WaterBillDemand,,16-Nov,16-Nov,M,01-12-16,1011063,27228,1,3675930,,12109845.77
1,215, 05/12/2016,,ArrearInterestDemand,,,,,,,,,92023.91,,12201869.68
1,216, 05/12/2016,,LatePaymentFee,,,,,,,,,87893.4,,12289763.08
1,217, 28/12/2016,SBHYR52016122810004676,WaterBillCollection,,,,,,,,,,"3,675,930.00",8613833.08
1,218, 02/01/2017,71362737,WaterBillDemand,,16-Dec,16-Dec,M,31-12-16,1034329,23266,1,3141060,,11754893.08
1,219, 02/01/2017,,ArrearInterestDemand,,,,,,,,,93342.31,,11848235.39
1,220, 02/01/2017,,LatePaymentFee,,,,,,,,,73518.6,,11921753.99
1,221, 12/01/2017,SBHYR52017011210004661,WaterBillCollection,,,,,,,,,,"3,141,060.00",8780693.99
1,222, 02/02/2017,72298521,WaterBillDemand,,17-Jan,17-Jan,M,31-01-17,1059113,24784,1,3345990,,12126683.99
1,223, 02/02/2017,,ArrearInterestDemand,,,,,,,,,94445.09,,12221129.08
1,224, 27/02/2017,SBHYR52017022710011951,WaterBillCollection,,,,,,,,,,"3,345,990.00",8875139.08
1,225, 02/03/2017,73262423,WaterBillDemand,,17-Feb,17-Feb,M,28-02-17,1084296,25183,1,3399855,,12274994.08
1,226, 02/03/2017,,ArrearInterestDemand,,,,,,,,,94445.09,,12369439.17
1,227, 02/03/2017,,LatePaymentFee,,,,,,,,,66919.8,,12436358.97
1,228, 21/03/2017,SBHYR52017032110005947,WaterBillCollection,,,,,,,,,,"3,399,855.00",9036503.97
1,229, 02/04/2017,74204090,WaterBillDemand,,17-Mar,17-Mar,M,31-03-17,1111476,27180,1,3669450,,12705953.97
1,230, 02/04/2017,,ArrearInterestDemand,,,,,,,,,95448.89,,12801402.86
1,231, 02/04/2017,,LatePaymentFee,,,,,,,,,67997.1,,12869399.96
1,232, 18/04/2017,SBHYR52017041810004254,WaterBillCollection,,,,,,,,,,"3,669,450.00",9199949.96
1,233, 02/05/2017,75137699,WaterBillDemand,,17-Apr,17-Apr,M,30-04-17,1138366,26890,1,3630300,,12830249.96
1,234, 02/05/2017,,ArrearInterestDemand,,,,,,,,,96468.85,,12926718.81
1,235, 02/05/2017,,LatePaymentFee,,,,,,,,,73389,,13000107.81
1,236, 12/05/2017,SBHYR52017051210004971,WaterBillCollection,,,,,,,,,,"3,630,300.00",9369807.81
1,237, 02/06/2017,76093391,WaterBillDemand,,17-May,17-May,M,31-05-17,1172386,34020,1,4592850,,13962657.81
1,238, 02/06/2017,,ArrearInterestDemand,,,,,,,,,97569.68,,14060227.49
1,239, 30/06/2017,SBINR52017063010016318,WaterBillCollection,,,,,,,,,,"4,592,850.00",9467377.49
1,240, 02/07/2017,77045372,WaterBillDemand,,17-Jun,17-Jun,M,30-06-17,1203164,30778,1,4155180,,13622557.49
1,241, 02/07/2017,,ArrearInterestDemand,,,,,,,,,97569.68,,13720127.17
1,242, 02/07/2017,,LatePaymentFee,,,,,,,,,91857,,13811984.17
1,243, 11/07/2017,SBINR52017071110042091,WaterBillCollection,,,,,,,,,,"4,155,180.00",9656804.17
1,244, 02/08/2017,78002403,WaterBillDemand,,17-Jul,17-Jul,M,31-07-17,1230144,26980,1,3642450,,13299254.17
1,245, 02/08/2017,,ArrearInterestDemand,,,,,,,,,98947.54,,13398201.71
1,246, 28/08/2017,SBINR52017082810054169,WaterBillCollection,,,,,,,,,,"3,642,450.00",9755751.71
1,247, 02/09/2017,78955649,WaterBillDemand,,17-Aug,17-Aug,M,31-08-17,1258913,28769,1,3883965,,13639716.71
1,248, 02/09/2017,,ArrearInterestDemand,,,,,,,,,98947.54,,13738664.25
1,249, 02/09/2017,,LatePaymentFee,,,,,,,,,72849,,13811513.25
1,250, 25/09/2017,SBINR52017092510057822,WaterBillCollection,,,,,,,,,,"3,883,965.00",9927548.25
1,251, 02/10/2017,79895082,WaterBillDemand,,17-Sep,17-Sep,M,30-09-17,1298960,40047,1,5406495,,15334043.25
1,252, 02/10/2017,,ArrearInterestDemand,,,,,,,,,100040.27,,15434083.52
1,253, 02/10/2017,,LatePaymentFee,,,,,,,,,77679.3,,15511762.82
1,254, 28/10/2017,79895082,ReverseWaterBillDemand,,17-Sep,17-Sep,M,30-09-17,1298960,40047,1,,"5,406,495.00",10105267.82
1,255, 28/10/2017,,ReverseArrearInterestDemand,,,,,,,,,,"100,040.27",10005227.55
1,256, 28/10/2017,,ReverseLatePaymentFee,,,,,,,,,,"77,679.30",9927548.25
1,257, 28/10/2017,80812987,WaterBillDemand,,17-Sep,17-Sep,M,01-10-17,1286644,27731,1,3743835,,13671383.25
1,258, 02/11/2017,80873199,WaterBillDemand,,17-Oct,17-Oct,M,31-10-17,1314086,27442,1,3704820,,17376203.25
1,259, 02/11/2017,,ArrearInterestDemand,,,,,,,,,100040.27,,17476243.52
1,260, 06/11/2017,SBINR52017110610047447,WaterBillCollection,,,,,,,,,,"3,743,835.00",13732408.52
1,261, 16/11/2017,SBINR52017111610046401,WaterBillCollection,,,,,,,,,,"3,704,820.00",10027588.52
1,262, 02/12/2017,81763012,WaterBillDemand,,17-Nov,17-Nov,M,30-11-17,1340512,26426,1,3567660,,13595248.52
1,263, 02/12/2017,,ArrearInterestDemand,,,,,,,,,100040.27,,13695288.79
1,264, 22/12/2017,SBINR52017122210066318,WaterBillCollection,,,,,,,,,,"3,567,660.00",10127628.79
1,265, 02/01/2018,82724244,WaterBillDemand,,17-Dec,17-Dec,M,31-12-17,1371418,30906,1,4172460,,14300088.79
1,266, 02/01/2018,,ArrearInterestDemand,,,,,,,,,100040.27,,14400129.06
1,267, 02/01/2018,,LatePaymentFee,,,,,,,,,71353.2,,14471482.26
1,268, 29/01/2018,SBINR52018012910063722,WaterBillCollection,,,,,,,,,,"4,172,460.00",10299022.26
2,1, 10/02/2016,,WaterRevenueOpeningBalance,,,,,,,,,,,0
2,2, 30/08/2016,67552202,WaterBillDemand,,Feb-16,Jul-16,M,30-08-16,435,5940,6,81090,,81090
2,3, 20/09/2016,68239118,WaterBillDemand,,Aug-16,Aug-16,M,20-09-16,509,990,1,13515,,94605
2,4, 29/09/2016,68239118,ReverseWaterBillDemand,,Aug-16,Aug-16,M,20-09-16,509,990,1,,"13,515.00",81090
2,5, 29/09/2016,67552202,ReverseWaterBillDemand,,Feb-16,Jul-16,M,30-08-16,435,5940,6,,"81,090.00",0
2,6, 06/10/2016,4749395,WaterBillCollection,CSH,,,,,,,,,"27,640.00",-27640
2,7, 12/11/2016,4836922,WaterBillCollection,CSH,,,,,,,,,"15,000.00",-42640
2,8, 26/11/2016,70370097,WaterBillDemand,,Feb-16,Oct-16,M,14-11-16,77,2970,9,41445,,-1195
2,9, 20/12/2016,71238660,WaterBillDemand,,Nov-16,Nov-16,M,20-12-16,106,330,1,4605,,3410
2,10, 25/01/2017,72255973,WaterBillDemand,,Dec-16,Dec-16,M,25-01-17,220,330,1,4605,,8015
2,11, 23/02/2017,73180807,WaterBillDemand,,Jan-17,Jan-17,M,23-02-17,380,160,1,5847,,13862
2,12, 23/02/2017,D000001260,ArrearInterestDemand,,,,,,,,,51.15,,13913.15
2,13, 22/03/2017,74100153,WaterBillDemand,,Feb-17,Feb-17,M,22-03-17,506,330,1,4605,,18518.15
2,14, 22/03/2017,D000001135,ArrearInterestDemand,,,,,,,,,120.23,,18638.38
2,15, 22/03/2017,D000001135,LatePaymentFee,,,,,,,,,92.1,,18730.48
2,16, 21/04/2017,75020910,WaterBillDemand,,Mar-17,Mar-17,M,21-04-17,600,330,1,4605,,23335.48
2,17, 21/04/2017,D000001097,ArrearInterestDemand,,,,,,,,,207.93,,23543.41
2,18, 21/04/2017,D000001097,LatePaymentFee,,,,,,,,,116.94,,23660.35
2,19, 25/05/2017,76027768,WaterBillDemand,,Apr-17,Apr-17,M,25-05-17,762,162,1,5941.5,,29601.85
2,20, 25/05/2017,D000001209,ArrearInterestDemand,,,,,,,,,278.39,,29880.24
2,21, 25/05/2017,D000001209,LatePaymentFee,,,,,,,,,92.1,,29972.34
2,22, 21/06/2017,76922484,WaterBillDemand,,May-17,May-17,M,21-06-17,875,330,1,4605,,34577.34
2,23, 21/06/2017,D000001126,ArrearInterestDemand,,,,,,,,,349.22,,34926.56
2,24, 21/06/2017,D000001126,LatePaymentFee,,,,,,,,,92.1,,35018.66
2,25, 17/07/2017,77739289,WaterBillDemand,,Jun-17,Jun-17,M,17-07-17,980,330,1,4605,,39623.66
2,26, 17/07/2017,D000000860,ArrearInterestDemand,,,,,,,,,439.72,,40063.38
2,27, 17/07/2017,D000000860,LatePaymentFee,,,,,,,,,118.83,,40182.21
2,28, 21/08/2017,78826383,WaterBillDemand,,Jul-17,Jul-17,M,21-08-17,1116,136,1,4713,,44895.21
2,29, 21/08/2017,D000001266,ArrearInterestDemand,,,,,,,,,581.03,,45476.24
2,30, 21/08/2017,D000001266,LatePaymentFee,,,,,,,,,184.2,,45660.44
2,31, 24/08/2017,5397974,WaterBillCollection,CSH,,,,,,,,,"45,660.00",0.44
2,32, 21/09/2017,79792826,WaterBillDemand,,Aug-17,Aug-17,M,21-09-17,1268,152,1,5469,,5469.44
2,33, 21/10/2017,80731724,WaterBillDemand,,Sep-17,Sep-17,M,21-10-17,1409,141,1,4949.25,,10418.69
2,34, 24/11/2017,81748435,WaterBillDemand,,Oct-17,Oct-17,M,24-11-17,1560,151,1,5421.75,,15840.44
2,35, 24/11/2017,D000001280,ArrearInterestDemand,,,,,,,,,82.04,,15922.48
2,36, 24/11/2017,D000001280,LatePaymentFee,,,,,,,,,109.38,,16031.86
